# tool-id <tab> bio.tools-id
abyss-pe	abyss
allegro	allegro
datasets_download_genome	ncbi_resources
ncbi_acc_download	ncbi_resources
uniprotxml_downloader	uniprot
unipept	unipept
iedb_api	iedb
sam_dump	sra
sra_pileup	sra
ncbi_eutils_esearch	ncbi_resources
ncbi_eutils_egquery	ncbi_resources
ncbi_eutils_ecitmatch	ncbi_resources
ncbi_eutils_epost	ncbi_resources
ncbi_eutils_elink	ncbi_resources
ncbi_eutils_einfo	ncbi_resources
ncbi_eutils_esummary	ncbi_resources
ncbi_eutils_efetch	ncbi_resources
uniprot	uniprot
get_sequences	ensembl
get_genetree	ensembl
get_feature_info	ensembl
enasearch_search_data	ena
enasearch_retrieve_data	ena
enasearch_retrieve_taxons	ena
enasearch_retrieve_analysis_report	ena
enasearch_retrieve_run_report	ena
ebi_search_rest_results	ebi_search
ebi_metagenomics_run_downloader	ebi_tools
pyega3	ega
ena_upload	ena
gops_basecoverage_1	bx-python
gops_subtract_1	bx-python
gops_complement_1	bx-python
gops_cluster_1	bx-python
gff3.rebase	gff3_rebase
gops_coverage_1	bx-python
gops_merge_1	bx-python
gops_intersect_1	bx-python
flanking_features_1	bx-python
get_flanks1	bx-python
subtract_query1	bx-python
gffcompare	gffcompare
sample_seqs	biopython
seq_filter_by_id	biopython
rxlr_motifs	signalp
rxlr_motifs	hmmer2
crossmap_bam	crossmap
samtools_bam_to_cram	samtools
crossmap_region	crossmap
crossmap_bed	crossmap
crossmap_gff	crossmap
crossmap_vcf	crossmap
crossmap_wig	crossmap
msconvert	msconvert
bed_to_protein_map	bed_to_protein_map
gffcompare_to_bed	gffcompare
idconvert	idconvert
msconvert_subset	msconvert
idconvert	idconvert
bigwig_to_bedgraph	bigwig_to_bedgraph
fastp	fastp
cshl_fastx_clipper	clip
rcorrector	recorrector
filtlong	filtlong
trimmomatic	trimmomatic
fasta_compute_length	compute_sequence_length
fastq_quality_trimmer	fastx-toolkit
fastq_to_fasta_python	fastx-toolkit
cshl_fastx_renamer	chsl_fastx_renamer
cshl_fastx_reverse_complement	cshl_fastx_reverse_complement
cshl_fastx_trimmer	cshl_fastx_trimmer
cshl_fastq_to_fasta	fastx-toolkit
cshl_fastx_quality_statistics	cshl_fastx_quality_statistics
cshl_fastq_quality_boxplot	fastx-toolkit
cshl_fastq_quality_converter	fastx-toolkit
cshl_fastq_quality_filter	fastx-toolkit
cshl_fasta_formatter	fastx-toolkit
cshl_fasta_nucleotides_changer	fastx-toolkit
cshl_fastx_collapser	cshl_fastx_collapser
cshl_fastx_artifacts_filter	cshl_fastx_artifacts_filter
exonerate	exonerate
sickle	sickle
flash	flash
seqtk_comp	seqtk
seqtk_mutfa	seqtk
seqtk_hety	seqtk
seqtk_cutN	seqtk
seqtk_mergefa	seqtk
seqtk_trimfq	seqtk
seqtk_fqchk	seqtk
seqtk_randbase	seqtk
seqtk_subseq	seqtk
seqtk_dropse	seqtk
seqtk_mergepe	seqtk
seqtk_seq	seqtk
seqtk_listhet	seqtk
seqtk_listhet	seqtk
mqc	mQC
cshl_fastx_nucleotides_distribution	cshl_fastx_nucleotides_distribution
cshl_fastx_barcode_splitter	cshl_princeton_fastx_barcode_splitter
lighter	lighter
qualimap_counts	qualimap
samtools_coverage	samtools
bamtools	bamtools
bamFilter	bamtools
bamtools_split_paired	bamtools
bamtools_split_ref	bamtools
bamtools_split_mapped	bamtools
bamtools_split_tag	bamtools
samtools_phase	samtools
samtools_fastx	samtools
samtools_view	samtools
samtools_stats	samtools
samtools_split	samtools
samtools_flagstat	samtools
samtools_markdup	samtools
samtools_slice_bam	samtools
samtools_idxstats	samtools
samtools_sort	samtools
samtools_bedcov	samtools
bamutil_diff	bamutil
samtools_reheader	samtools
qualimap_bamqc	qualimap
sam_pileup	samtools
qualimap_multi_bamqc	qualimap
bamtools_split	bamtools
samtools_mpileup	samtools
samtools_calmd	samtools
samtools_merge	samtools
samtools_depth	samtools
samtools_fixmate	samtools
samtool_filter2	samtools
ngsutils_bam_filter	ngsutils
samtools_rmdup	samtools
sam_merge2	Broken link in tool shed
bamhash	bamhash
bedtools_annotatebed	bedtools
bedtools_bed12tobed6	bedtools
bedtools_bedtobam	bedtools
bedtools_bedtoigv	bedtools
bedtools_bedpetobam	bedtools
bedtools_closestbed	bedtools
bedtools_clusterbed	bedtools
bedtools_complementbed	bedtools
bedtools_coveragebed	bedtools
bedtools_expandbed	bedtools
bedtools_fisher	bedtools
bedtools_flankbed	bedtools
bedtools_genomecoveragebed	bedtools
bedtools_getfastabed	bedtools
bedtools_groupbybed	bedtools
bedtools_intersectbed	bedtools
bedtools_jaccard	bedtools
bedtools_links	bedtools
bedtools_makewindowsbed	bedtools
bedtools_map	bedtools
bedtools_maskfastabed	bedtools
bedtools_mergebed	bedtools
bedtools_multicovtbed	bedtools
bedtools_multiintersectbed	bedtools
bedtools_nucbed	bedtools
bedtools_overlapbed	bedtools
bedtools_randombed	bedtools
bedtools_reldistbed	bedtools
bedtools_shufflebed	bedtools
bedtools_slopbed	bedtools
bedtools_sortbed	bedtools
bedtools_spacingbed	bedtools
bedtools_subtractbed	bedtools
bedtools_tagbed	bedtools
bedtools_unionbedgraph	bedtools
bedtools_windowbed	bedtools
gffcompare	bedtools
bedtools_bamtofastq	bedtools
bedtools_genomecoveragebed_bedgraph	bedtools
bedtools_mergebedgraph	bedtools
bedtools_genomecoveragebed_histogram	bedtools
varscan_somatic	varscan
varscan_copynumber	varscan
bcftools_csq	bcftools
bcftools_cnv	bcftools
bcftools_consensus	bcftools
bcftools_norm	bcftools
bcftools_call	bcftools
vcfcheck	vcflib
vcffilter2	vcflib
vcfselectsamples	vcflib
vcfannotategenotypes	vcflib
vcfflatten2	vcflib
vcfcommonsamples	vcflib
vcfannotate	vcflib
vcfvcfintersect	vcflib
vcfbreakcreatemulti	vcflib
vcfallelicprimitives	vcflib
vcfgeno2haplo	vcflib
vcffixup	vcflib
vcfgenotypes	vcflib
vcfbedintersect	vcflib
vcfrandomsample	vcflib
vcfhethom	vcflib
vcfsort	vcflib
vcfprimers	vcflib
vcfcombine	vcflib
vcfleftalign	vcflib
vcf2tsv	vcflib
vcfaddinfo	vcflib
varscan	varscan
varscan_mpileup	varscan
bcfview	bcftools
freebayes	freebayes
vcfdistance	vcflib
snippy	snippy
snippy_core	snippy
bamleftalign	freebayes
vcfdistance	vcflib
vcftools_merge	vcftools
vcftools_isec	vcftools
vt_normalize	vt
vcftools_compare	vcftools
vcftools_annotate	vcftools
vcftools_slice	vcftools
vcftools_subset	vcftools
medaka_variant_pipeline	medaka
medaka_variant	medaka
medaka_consensus	medaka
ngmlr	ngmlr
medaka_consensus_pipeline	medaka
nanocompore_db	Nanocompore
nanoplot	nanoplot
nanopolish_polya	nanopolish
nanopolish_eventalign	nanopolish
nanopolish_methylation	nanopolish
nanopolish_variants	nanopolish
nanocompore_sampcomp	Nanocompore
nanopolishcomp_freqmethcalculate	nanopolish
nanopolishcomp_eventaligncollapse	nanopolish
poretools_times	poretools
poretools_nucdist	poretools
poretools_qualdist	poretools
poretools_extract	poretools
poretools_tabular	poretools
poretools_stats	poretools
poretools_squiggle	poretools
poretools_occupancy	poretools
poretools_hist	poretools
poretools_yield_plot	poretools
poretools_qualpos	poretools
poretools_winner	poretools
poretools_events	poretools
gops_complement_1	bx-python
gops_cluster_1	bx-python
gops_basecoverage_1	bx-python
Annotation_Profiler_0	bx-python
translate_bed	biopython
gops_concat_1	bx-python
gops_join_1	bx-python
translate_bed_sequences	biopython
Extract genomic DNA 1	bx-python
fraggenescan	fraggenescan
repeatmodeler	repeatmodeler
promoter2	promoter
Psortb	psortb
signalp3	signalp
tmhmm2	tmhmm
wolf_psort	wolf_psort
tbvcfreport	combat-tb_workbench
tb_profiler_profile	tb-profiler
homer_annotatePeaks	homer
funannotate_annotate	funannotate
funannotate_predict	funannotate
tb_variant_filter	combat-tb_workbench
augustus_training	augustus
augustus	augustus
chipseeker	chipseeker
spotyping	spotyping
hmmer_hmmbuild	hmmer3
hmmer_hmmscan	hmmer3
annotatemyids	annotatemyids
mitos2	mitos
sistr_cmd	SISTR
hhsearch	hhsuite
optitype	optitype
hmmer_nhmmer	hmmer3
hmmer_phmmer	hmmer3
hmmer_jackhmmer	hmmer3
hmmer_nhmmscan	hmmer3
hmmer_hmmsearch	hmmer3
tbl2gff3	tbl2gff3
hmmer_hmmemit	hmmer3
hmmer_hmmalign	hmmer3
homer_gtf_to_annotations	homer
funannotate_clean	funannotate
funannotate_sort	funannotate
funannotate_compare	funannotate
hmmer_hmmfetch	hmmer3
hmmer_alimask	hmmer3
hmmer_hmmconvert	hmmer3
mob_recon	mob-suite
mob_typer	mob-suite
seq2hla	seq2hla
mitos	mitos
ectyper	ectyper
antismash	antismash
xmfa2gff3	mauve
mlst_list	mlst
mlst	mlst
exonerate	exonerate
fastani	fastani
kobas_annotate	kobas
kobas_identify	kobas
gprofiler_snpense	gprofiler
gprofiler_random	gprofiler
gprofiler_gost	gprofiler
gprofiler_orth	gprofiler
gprofiler_convert	gprofiler
blastxml_to_gapped_gff3	blastxml_to_gapped_gff3
snap_training	snap
fgsea	fgsea
bg_sortmerna	sortmerna
goslimmer	goenrichment
goenrichment	goenrichment
hammock_1.0	hammock
picrust_metagenome_contributions	picrust
picrust_format_tree_and_trait_table	picrust
picrust_compare_biom	picrust
picrust_predict_metagenomes	picrust
picrust_categorize	picrust
trnascan	trnascan-se
aragorn_trna	aragorn
transtermhp	transtermhp
gubbins	gubbins
Probmetab	probmetab
lcmsmatching	workflow4metabolomics
blast2go	blast2go
hmmer_nhmmer	hmmer3
hmmer_hmmsearch	hmmsearch
hmmer_hmmconvert	hmmsearch
hmmer_hmmfetch	hmmsearch
hmmer_jackhmmer	hmmsearch
hmmer_alimask	hmmsearch
hmmer_hmmscan	hmmsearch
hmmer_nhmmscan	hmmsearch
hmmer_hmmemit	hmmsearch
hmmer_phmmer	hmmsearch
hmmer_hmmalign	hmmsearch
hmmer_hmmbuild	hmmsearch
rbc_gotohscan	GotohScan
CryptoGenotyper	CryptoGenotyper
rbc_mafft_add	MAFFT
rbc_mafft	MAFFT
clustalw	clustalw
sina	sina
gecko	gecko
hammock_1.0	hammock
muscle	muscle
raven	raven
spades_coronaspades	coronaspades
spades_plasmidspades	plasmidspades
spades	spades
metaspades	metaspades
rnaspades	rnaspades
trycycler_cluster	trycycler
trycycler_consensus	trycycler
trycycler_partition	trycycler
trycycler_reconcile_msa	trycycler
trycycler_subsample	trycycler
flye	Flye
genomescope	GenomeScope_2.0
miniasm	miniasm
racon	Racon
lordec	lordec
shasta	shasta
idba_tran	idba
unicycler	unicycler
idba_ud	idba
idba_hybrid	idba
velvetoptimiser	velvetoptimiser
pilon	pilon
wtdbg	wtdbg2
mira_assembler	mira
edena_ass_wrapper	edena
edena_ovl_wrapper	edena
sopra_wpc	sopra
ssake	ssake
minced	minced
bbtools_bbmap	bbmap
kma_map	kma
hisat2	hisat2
bwa_mem	bwa
lastz_paired_reads_wrapper	lastz
bowtie_wrapper	bowtie
bismark_bowtie2	bismark
star_fusion	star-fusion
bismark_deduplicate	bismark
bismark_pretty_report	bismark
bismark_methylation_extractor	bismark
segemehl	segemehl
bismark_bowtie	bismark
bwa	bwa
tophat2	tophat2
pharmcat	pharmcat
varscan_somatic	varscan
varscan_copynumber	varscan
varscan_mpileup	varscan
delly_classify	delly2
deepvariant	deepvariant
snippy_core	snippy
snippy	snippy
snippy_clean_full_aln	snippy
lumpy_sv	lumpy
beagle	beagle
irissv	iris
jasminesv	jasmine-sv
strelka_germline	strelka
strelka_somatic	strelka
lumpy_prep	lumpy
vardict_java	vardict
artic_guppyplex	artic
snpSift_filter	snpsift
lofreq_filter	lofreq
lofreq_call	lofreq
cutesv	cuteSV
sniffles	sniffles
snpeff_sars_cov_2	snpeff
lofreq_viterbi	lofreq
lofreq_alnqual	lofreq
lofreq_indelqual	lofreq
odgi_viz	odgi
odgi_build	odgi
vg_view	vg
vg_deconstruct	vg
vg_convert	vg
snpEff_get_chr_names	snpeff
exomedepth	exomedepth
snpEff_build_gb	snpeff
mixcr_analyze	mixcr
snpEff_databases	snpeff
snpEff_download	snpeff
snpSift_int	snpsift
snpSift_rmInfo	snpsift
snpSift_annotate	snpsift
snpsift_vartype	snpsift
snpSift_caseControl	snpsift
snpSift_extractFields	snpsift
snpSift_vcfCheck	snpsift
snpEff	snpeff
snpSift_geneSets	snpsift
snpSift_dbnsfp	snpsift
snpSift_dbnsfp_generic	snpsift
SnpEff-cds-report	snpeff
snpeff_to_peptides	snpeff
snpSift_int	snpsift
snpSift_annotate	snpsift
snpSift_filter	snpsift
snpSift_caseControl	snpsift
mageck_test	mageck
mageck_mle	mageck
mageck_gsea	mageck
mageck_count	mageck
mageck_pathway	mageck
plotdexseq	dexseq
seurat	seurat
alleyoop	SLAM-DUNK
slamdunk	SLAM-DUNK
cuffmerge	cufflinks
salmonquantmerge	salmon
egsea	egsea
targetfinder	targetfinder.org
migmap	MiGMAP
kallisto_pseudo	kallisto
kallisto_quant	kallisto
ruvseq	ruvseq
salmon	salmon
genomic_super_signature	genomicsupersignature
express	express
masigpro	masigpro
cufflinks	cufflinks
cuffdiff	cuffdiff
cuffcompare	cuffcompare
scpipe	scpipe
cuffnorm	cufflinks
cummeRbund	cummerbund
htseq_count	htseqcount
graphprot_predict_profile	graphprot
heinz_visualization	heinz
qualimap_counts	qualimap
qualimap_rnaseq	qualimap
bg_sortmerna	sortmerna
glassgo	glassgo
intarna	intarna
trinity_analyze_diff_expr	trinity
rnaz_cluster	rnaz
dr_disco_classify	dr_disco
dr_disco_fix	dr_disco
dr_disco_bam_extract	dr_disco
dr_disco_integrate	dr_disco
dr_disco_detect	dr_disco
mea	mea
rnaz_randomize_aln	rnaz
rnaz_select_seqs	rnaz
rnaz_window	rnaz
rnaz_annotate	rnaz
locarna_multiple	locarna
ribotaper_create_metaplots	ribotaper
ribotaper_ribosome_profiling	ribotaper
ribotaper_create_annotation	ribotaper
pipmir	pipmir
nastiseq	nastiseq
flaimapper	flaimapper
AREsite2_REST	aresite
fuma	fuma
RNAlien	rnalien
trinity_samples_qccheck	trinity
describe_samples	trinity
trinity_define_clusters_by_cutting_tree	trinity
rseqc_geneBody_coverage	resqc
heinz_bum	heinz
heinz	heinz
heinz_scoring	heinz
pizzly	pizzly
rcas	rcas
rseqc_geneBody_coverage2	rseqc
rseqc_RPKM_saturation	rseqc
rseqc_infer_experiment	rseqc
rseqc_RNA_fragment_size	rseqc
rseqc_tin	rseqc
rseqc_junction_saturation	rseqc
rseqc_FPKM_count	rseqc
rseqc_read_distribution	rseqc
rseqc_junction_annotation	rseqc
rseqc_inner_distance	rseqc
rnaz	rnaz
RNAshapes	rnashpaes
viennarna_rnafold	vienna_rna_package
idr	idr
viennarna_rnacofold	vienna_rna_package
viennarna_rnaalifold	vienna_rna_package
rseqc_deletion_profile	rseqc
rseqc_read_NVC	rseqc
rseqc_bam_stat	rseqc
rseqc_read_duplication	rseqc
rseqc_read_GC	rseqc
rseqc_insertion_profile	rseqc
rseqc_bam2wig	rseqc
rseqc_clipping_profile	rseqc
rseqc_read_quality	resqc
rseqc_read_hexamer	resqc
rseqc_mismatch_profile	resqc
segemehl	segemehl
sailfish	sailfish
cuffquant	cufflinks
viennarna_rnaeval	viennarna
viennarna_rnaplex	viennarna
viennarna_rna2dfold	viennarna
viennarna_rnapaln	viennarna
viennarna_rnaplot	viennarna
viennarna_rnasnoop	viennarna
viennarna_kinfold	viennarna
viennarna_rnaaliduplex	viennarna
viennarna_rnaduplex	viennarna
viennarna_rnadistance	viennarna
viennarna_rnadpdist	viennarna
viennarna_rnalfold	viennarna
viennarna_rnapkplex	viennarna
viennarna_rnaup	viennarna
viennarna_rnalalifold	viennarna
viennarna_rnainverse	viennarna
viennarna_rnaheat	viennarna
viennarna_rnasubopt	viennarna
rnasnp	rnasnp
mlocarna	locarna
paralyzer	paralyzer
rbc_rnacommender	rnacommender
rseqc_RPKM_count	rseqc
tophat_fusion_post	tophat-fusion
blockbuster	blockbuster
rbc_kinwalker	kinwalker
antarna	antarna
cummerbund_to_cuffdiff	cummerbund
rbc_mirdeep2_mapper	mirdeep2
rbc_mirdeep2_quantifier	mirdeep2
rbc_mirdeep2	mirdeep2
rsem_prepare_reference	rsem
rsem_calculate_expression	rsem
extract_transcript_to_gene_map_from_trinity	rsem
peakcalling_ccat	ccat
peakcalling_macs	macs
peakcalling_sicer	sicer
diffbind	diffbind
peakachu	peakachu
jamm	jamm
piranha	piranha-peak
pileometh	methyldackel
minfi_ppquantile	ewastools
minfi_rset	ewastools
minfi_dropsnp	ewastools
minfi_mset	ewastools
minfi_read450k	ewastools
minfi_ppfun	ewastools
minfi_dmp	ewastools
minfi_dmr	ewastools
minfi_getcn	ewastools
minfi_getbeta	ewastools
minfi_getsnp	ewastools
minfi_maptogenome	ewastools
minfi_getM	ewastools
minfi_qc	ewastools
minfi_analysis	ewastools
hicup_truncater	hicup
hicup_hicup	hicup
hicup_filter	hicup
hicup_digester	hicup
hicup_deduplicator	hicup
hicup_mapper	hicup
hyphy_cfel	HyPhy
hyphy_strike_ambigs	HyPhy
hyphy_conv	HyPhy
nextclade	nextstrain.org
hyphy_summary	HyPhy
hyphy_annotate	HyPhy
t_coffee	tcoffee
raxml	raxml
gstf_preparation	geneseqtofamily
phyml	phyml
blast_parser	blast
hgv_hilbertvis	hilbertvis
ctdBatch_1	ctd
music_construct_eset	popmusic
music_deconvolution	popmusic
music_compare	popmusic
alevin	Alevin
music_inspect_eset	popmusic
dropletutils_read_10x	dropletutils
dropletutils_empty_drops	dropletutils
ip_slice_image	scikit-image
scanpy_parameter_iterator	scanpy
scater_plot_exprs_freq	scater
scater_normalize	scater
picard_CollectBaseDistributionByCycle	picard
picard_AddOrReplaceReadGroups	picard
picard_MeanQualityByCycle	picard
picard_RevertOriginalBaseQualitiesAndAddMateCigar	picard
picard_CollectHsMetrics	picard
picard_SortSam	picard
picard_RevertSam	picard
picard_FixMateInformation	picard
picard_CASM	picard
picard_NormalizeFasta	picard
picard_DownsampleSam	picard
picard_MergeBamAlignment	picard
picard_MarkDuplicatesWithMateCigar	picard
picard_CleanSam	picard
picard_MergeSamFiles	picard
picard_MarkDuplicates	picard
picard_ValidateSamFile	picard
picard_QualityScoreDistribution	picard
picard_CollectRnaSeqMetrics	picard
picard_BedToIntervalList	picard
picard_CollectWgsMetrics	picard
picard_artifact_metrics	picard
picard_CollectGcBiasMetrics	picard
picard_FilterSamReads	picard
picard_AddCommentsToBam	picard
picard_EstimateLibraryComplexity	picard
picard_CollectInsertSizeMetrics	picard
PicardASMetrics	picard
picard_BamIndexStats	picard
picard_ARRG	picard
rgEstLibComp	picard
PicardInsertSize	picard
rgPicFixMate	picard
deeptools_bam_compare	deeptools
deeptools_bam_pe_fragmentsize	deeptools
deeptools_multi_bam_summary	deeptools
deeptools_compute_matrix	deeptools
deeptools_plot_enrichment	deeptools
deeptools_bam_coverage	deeptools
deeptools_bigwig_compare	deeptools
deeptools_plot_heatmap	deeptools
deeptools_correct_gc_bias	deeptools
deeptools_alignmentsieve	deeptools
deeptools_compute_matrix_operations	deeptools
deeptools_plot_fingerprint	deeptools
deeptools_plot_coverage	deeptools
deeptools_plot_correlation	deeptools
deeptools_plot_profile	deeptools
deeptools_multi_bigwig_summary	deeptools
deeptools_compute_gc_bias	deeptools
deeptools_plot_pca	deeptools
deeptools_estimatereadfiltering	deeptools
hicup_deduplicator	hicup
gemini_query	gemini
gemini_annotate	gemini
gemini_load	gemini
scanpy_parameter_iterator	scanpy
scater_plot_exprs_freq	scater
scater_normalize	scater
picard_CollectBaseDistributionByCycle	picard_tools
picard_AddOrReplaceReadGroups	picard_tools
picard_MeanQualityByCycle	picard_tools
picard_RevertOriginalBaseQualitiesAndAddMateCigar	picard_tools
picard_CollectHsMetrics	picard_tools
picard_SortSam	picard_tools
picard_RevertSam	picard_tools
picard_FixMateInformation	picard_tools
picard_CASM	picard_tools
picard_NormalizeFasta	picard_tools
picard_DownsampleSam	picard_tools
picard_MergeBamAlignment	picard_tools
picard_MarkDuplicatesWithMateCigar	picard_tools
picard_CleanSam	picard_tools
picard_MergeSamFiles	picard_tools
picard_MarkDuplicates	picard_tools
picard_ValidateSamFile	picard_tools
picard_QualityScoreDistribution	picard_tools
picard_CollectRnaSeqMetrics	picard_tools
picard_BedToIntervalList	picard_tools
picard_CollectWgsMetrics	picard_tools
picard_artifact_metrics	picard_tools
picard_CollectGcBiasMetrics	picard_tools
picard_FilterSamReads	picard_tools
picard_AddCommentsToBam	picard_tools
picard_EstimateLibraryComplexity	picard_tools
picard_CollectInsertSizeMetrics	picard_tools
PicardASMetrics	picard_tools
picard_BamIndexStats	picard_tools
picard_ARRG	picard_tools
rgEstLibComp	picard_tools
PicardInsertSize	picard_tools
rgPicFixMate	picard_tools
deeptools_bam_compare	deeptools
deeptools_bam_pe_fragmentsize	deeptools
deeptools_multi_bam_summary	deeptools
deeptools_compute_matrix	deeptools
deeptools_plot_enrichment	deeptools
deeptools_bam_coverage	deeptools
deeptools_bigwig_compare	deeptools
deeptools_plot_heatmap	deeptools
deeptools_correct_gc_bias	deeptools
deeptools_alignmentsieve	deeptools
deeptools_compute_matrix_operations	deeptools
deeptools_plot_fingerprint	deeptools
deeptools_plot_coverage	deeptools
deeptools_plot_correlation	deeptools
deeptools_plot_profile	deeptools
deeptools_multi_bigwig_summary	deeptools
deeptools_compute_gc_bias	deeptools
deeptools_plot_pca	deeptools
deeptools_estimatereadfiltering	deeptools
hicup_deduplicator	hicup
gemini_query	gemini
gemini_annotate	gemini
gemini_load	gemini
gemini_db_info	gemini
gemini_pathways	gemini
gemini_windower	gemini
gemini_inheritance	gemini
gemini_interactions	gemini
gemini_qc	gemini
gemini_set_somatic	gemini
gemini_roh	gemini
gemini_fusions	gemini
gemini_lof_sieve	gemini
gemini_actionable_mutations	gemini
gemini_amend	gemini
gemini_stats	gemini
gemini_gene_wise	gemini
gemini_burden	gemini
EMBOSS: pepwheel72	emboss
EMBOSS: wordcount109	emboss
EMBOSS: trimest102	emboss
EMBOSS: pepwindow73	emboss
EMBOSS: pepwindowall74	emboss
EMBOSS: charge8	emboss
EMBOSS: degapseq20	emboss
EMBOSS: infoseq46	emboss
EMBOSS: splitter92	emboss
EMBOSS: skipseq91	emboss
EMBOSS: needle56	emboss
EMBOSS: patmatdb67	emboss
EMBOSS: marscan49	emboss
EMBOSS: water107	emboss
EMBOSS: getorf42	emboss
EMBOSS: lindna48	emboss
EMBOSS: msbar55	emboss
EMBOSS: oddcomp64	emboss
EMBOSS: fuzztran39	emboss
EMBOSS: tcode97	emboss
EMBOSS: pepcoil68	emboss
EMBOSS: helixturnhelix43	emboss
EMBOSS: iep45	emboss
EMBOSS: merger54	emboss
EMBOSS: equicktandem31	emboss
EMBOSS: newcpgseek58	emboss
EMBOSS: extractseq35	emboss
EMBOSS: dreg27	emboss
EMBOSS: maskfeat50	emboss
EMBOSS: newcpgreport57	emboss
EMBOSS: codcmp12	emboss
EMBOSS: dottup26	emboss
EMBOSS: supermatcher95	emboss
EMBOSS: nthseq62	emboss
EMBOSS: primersearch81	emboss
EMBOSS: fuzznuc37	emboss
EMBOSS: cutseq18	emboss
EMBOSS: tranalign100	emboss
EMBOSS: fuzzpro38	emboss
EMBOSS: cai_custom6	emboss
EMBOSS: noreturn60	emboss
EMBOSS: dotpath25	emboss
EMBOSS: etandem33	emboss
EMBOSS: octanol63	emboss
EMBOSS: sigcleave88	emboss
EMBOSS: wobble108	emboss
EMBOSS: wordmatch110	emboss
EMBOSS: union105	emboss
EMBOSS: megamerger53	emboss
EMBOSS: preg78	emboss
EMBOSS: prettyseq80	emboss
EMBOSS: prettyplot79	emboss
EMBOSS: einverted28	emboss
EMBOSS: sixpack90	emboss
EMBOSS: syco96	emboss
EMBOSS: cpgreport16	emboss
EMBOSS: pepstats71	emboss
EMBOSS: palindrome65	emboss
EMBOSS: hmoment44	emboss
EMBOSS: twofeat104	emboss
EMBOSS: digest23	emboss
EMBOSS: extractfeat34	emboss
EMBOSS: showfeat85	emboss
EMBOSS: shuffleseq87	emboss
EMBOSS: dotmatcher24	emboss
EMBOSS: seqmatchall83	emboss
EMBOSS: matcher52	emboss
EMBOSS: revseq82	emboss
EMBOSS: plotcon75	emboss
EMBOSS: trimseq103	emboss
EMBOSS: pasteseq66	emboss
EMBOSS: est2genome32	emboss
EMBOSS: diffseq22	emboss
EMBOSS: vectorstrip106	emboss
EMBOSS: polydot77	emboss
EMBOSS: transeq101	emboss
EMBOSS: isochore47	emboss
EMBOSS: backtranseq2	emboss
EMBOSS: compseq14	emboss
EMBOSS: freak36	emboss
EMBOSS: pepinfo69	emboss
EMBOSS: checktrans9	emboss
EMBOSS: antigenic1	emboss
EMBOSS: banana3	emboss
EMBOSS: dan19	emboss
EMBOSS: epestfind29	emboss
EMBOSS: maskseq51	emboss
EMBOSS: geecee41	emboss
EMBOSS: cpgplot15	emboss
EMBOSS: notseq61	emboss
EMBOSS: seqret84	emboss
EMBOSS: plotorf76	emboss
EMBOSS: cai6	emboss
EMBOSS: btwisted5	emboss
EMBOSS: newseq59	emboss
EMBOSS: chaos7	emboss
EMBOSS: pepnet70	emboss
EMBOSS: textsearch98	emboss
EMBOSS: chips10	emboss
EMBOSS: garnier40	emboss
EMBOSS: cusp17	emboss
EMBOSS: descseq21	emboss
EMBOSS: cirdna11	emboss
EMBOSS: tmap99	emboss
EMBOSS: sirna89	emboss
EMBOSS: coderet13	emboss
EMBOSS: biosed4	emboss
blastxml_to_tabular	blast
get_species_taxids	blast
ncbi_blastdbcmd_info	blast
ncbi_blastdbcmd_wrapper	blast
ncbi_blastn_wrapper	blast
ncbi_blastp_wrapper	blast
ncbi_blastx_wrapper	blast
ncbi_convert2blastmask_wrapper	blast
ncbi_dustmasker_wrapper	blast
ncbi_makeblastdb	blast
ncbi_makeprofiledb	blast
ncbi_rpsblast_wrapper	blast
ncbi_rpstblastn_wrapper	blast
ncbi_segmasker_wrapper	blast
ncbi_tblastn_wrapper	blast
ncbi_tblastx_wrapper	blast
bbtools_bbduk	bbmap
bg_diamond	diamond
bg_diamond_makedb	diamond
bg_diamond_view	diamond
taxonomy_krona_chart	taxonomy_krona_chart
bbtools_bbmap	bbmap
bbtools_callvariants	bbmap
kraken-translate	kraken
kraken-filter	kraken
hicexplorer_hicplotviewpoint	hicexplorer
hicexplorer_hicplotmatrix	hicexplorer
hicexplorer_hicfindtads	hicexplorer
hicexplorer_hiccomparematrices	hicexplorer
hicexplorer_hicaggregatecontacts	hicexplorer
hicexplorer_hicnormalize	hicexplorer
hicexplorer_hicsummatrices	hicexplorer
hicexplorer_hicconvertformat	hicexplorer
hicexplorer_hicadjustmatrix	hicexplorer
hicexplorer_hicinfo	hicexplorer
hicexplorer_hichyperoptDetectLoops	hicexplorer
schicexplorer_schicqualitycontrol	hicexplorer
hicexplorer_chicplotviewpoint	hicexplorer
hicexplorer_chicdifferentialtest	hicexplorer
hicexplorer_chicaggregatestatistic	hicexplorer
hicexplorer_chicsignificantinteractions	hicexplorer
hicexplorer_chicviewpoint	hicexplorer
hicexplorer_hicdifferentialtad	hicexplorer
hicexplorer_hicmergedomains	hicexplorer
hicexplorer_chicqualitycontrol	hicexplorer
hicexplorer_hicfindrestrictionsites	hicexplorer
hicexplorer_chicviewpointbackgroundmodel	hicexplorer
hicexplorer_hicquickqc	hicexplorer
hicexplorer_hicbuildmatrix	hicexplorer
hicexplorer_hicmergematrixbins	hicexplorer
hicexplorer_hictransform	hicexplorer
hicexplorer_hiccompartmentspolarization	hicexplorer
hicexplorer_hiccorrelate	hicexplorer
hicexplorer_hicdetectloops	hicexplorer
hicexplorer_hicmergeloops	hicexplorer
hicexplorer_hicvalidatelocations	hicexplorer
hicexplorer_hiccorrectmatrix	hicexplorer
hicexplorer_hicpca	hicexplorer
hicexplorer_hicplotaverageregions	hicexplorer
hicexplorer_hicplotdistvscounts	hicexplorer
hicexplorer_hicaverageregions	hicexplorer
hicexplorer_hicplotsvl	hicexplorer
schicexplorer_schiccorrectmatrices	hicexplorer
schicexplorer_schicplotconsensusmatrices	hicexplorer
schicexplorer_schicplotclusterprofiles	hicexplorer
schicexplorer_schicnormalize	hicexplorer
schicexplorer_schiccreatebulkmatrix	hicexplorer
schicexplorer_schicmergetoscool	hicexplorer
schicexplorer_schicmergematrixbins	hicexplorer
schicexplorer_schicinfo	hicexplorer
schicexplorer_schicdemultiplex	hicexplorer
schicexplorer_schicconsensusmatrices	hicexplorer
schicexplorer_schicclustersvl	hicexplorer
schicexplorer_schicclusterminhash	hicexplorer
schicexplorer_schicclustercompartments	hicexplorer
schicexplorer_schiccluster	hicexplorer
schicexplorer_schicadjustmatrix	hicexplorer
hicexplorer_hicplottads	hicexplorer
stacks2_shortreads	stacks
stacks2_refmap	stacks
stacks2_denovomap	stacks
stacks2_procrad	stacks
stacks2_populations	stacks
stacks2_gstacks	stacks
stacks2_ustacks	stacks
stacks2_kmerfilter	stacks
stacks2_clonefilter	stacks
stacks2_tsv2bam	stacks
stacks2_sstacks	stacks
BayeScan	bayescan
stacks2_cstacks	stacks
NSPDK_candidateClust	graphclust
structure_to_gspan	graphclust
preproc	graphclust
preMloc	graphclust
nspdk_sparse	graphclust
locarna_best_subtree	graphclust
gspan	graphclust
glob_report	graphclust
cmFinder	graphclust
graphclust_align_cluster	graphclust
graphclust_aggregate_alignments	graphclust
graphclust_glob_report_no_align	graphclust
motifFinderPlot	graphclust
infernal_cmbuild	infernal
infernal_cmsearch	infernal
infernal_cmstat	infernal
customize_metaphlan_database	metaphlan
merge_metaphlan_tables	metaphlan
metabat2_jgi_summarize_bam_contig_depths	MetaBAT_2
est_abundance	bracken
kraken2	kraken2
kraken	kraken
kraken-report	kraken
kraken-mpa-report	kraken
metaphlan	metaphlan
extract_metaphlan_database	metaphlan
metabat2	MetaBAT_2
kraken-translate	kraken
kraken-filter	kraken
taxonomy_krona_chart	krona
kraken_taxonomy_report	biopython
dada2_plotQualityProfile	dada2
dada2_mergePairs	dada2
dada2_assignTaxonomyAddspecies	dada2
dada2_makeSequenceTable	dada2
dada2_learnErrors	dada2
dada2_removeBimeraDenovo	dada2
dada2_dada	dada2
dada2_filterAndTrim	dada2
jellyfish	jellyfish
humann2	humann2
last_db	last
last_split	last
last_train	last
last_maf_convert	last
khmer_abundance_distribution_single	khmer
khmer_partition	khmer
khmer_count_median	khmer
khmer_abundance_distribution	khmer
khmer_filter_below_abundance_cutoff	khmer
khmer_filter_abundance	khmer
scoary	scoary
khmer_extract_partitions	khmer
khmer_normalize_by_median	khmer
mash_screen	mash
dada2_seqCounts	dada2
dada2_plotComplexity	dada2
humann2_join_tables	humann2
vsearch_search	vsearch
humann2_associate	humann2
humann2_barplot	humann2
humann2_genefamilies_genus_level	humann2
humann2_reduce_table	humann2
humann2_regroup_table	humann2
humann2_rename_table	humann2
humann2_renorm_table	humann2
humann2_rna_dna_norm	humann2
humann2_split_stratified_table	humann2
humann2_split_table	humann2
humann2_strain_profiler	humann2
humann2_unpack_pathways	humann2
metagene_annotator	metageneannotator
mash_sketch	mash
cat_contigs	cat_bins
cat_bins	cat_bins
cat_add_names	cat_bins
cat_summarise	cat_bins
cat_prepare	cat_bins
group_humann2_uniref_abundances_to_go	humann2
vsearch_sorting	vsearch
vsearch_chimera_detection	vsearch
vsearch_clustering	vsearch
vsearch_masking	vsearch
vsearch_alignment	vsearch
vsearch_dereplication	vsearch
vsearch_shuffling	vsearch
compare_humann2_output	humann2
combine_metaphlan2_humann2	humann2
format_metaphlan2_output	metaphlan
valet	valet
metaphlan2	metaphlan
metaphlan2krona	metaphlan
metaphlan_hclust_heatmap	metaphlan
metagenomeseq_normalizaton	metagenomeseq
qiime_collapse_samples	qiime
qiime_make_otu_table	qiime
qiime_pick_open_reference_otus	qiime
qiime_pick_closed_reference_otus	qiime
qiime_count_seqs	qiime
qiime_extract_barcodes	qiime
count_seqs	qiime
qiime_make_emperor	qiime
qiime_make_otu_heatmap	qiime
qiime_pick_rep_set	qiime
qiime_multiple_join_paired_ends	qiime
qiime_align_seqs	qiime
qiime_alpha_rarefaction	qiime
pick_open_reference_otus	qiime
pick_closed_reference_otus	qiime
qiime_core_diversity	qiime
qiime_alpha_diversity	qiime
qiime_split_libraries_fastq	qiime
qiime_filter_otus_from_otu_table	qiime
qiime_jackknifed_beta_diversity	qiime
qiime_filter_taxa_from_otu_table	qiime
qiime_pick_otus	qiime
qiime_compare_categories	qiime
qiime_plot_taxa_summary	qiime
qiime_upgma_cluster	qiime
qiime_filter_fasta	qiime
qiime_filter_alignment	qiime
qiime_assign_taxonomy	qiime
qiime_make_phylogeny	qiime
qiime_summarize_taxa	qiime
qiime_beta_diversity	qiime
qiime_split_libraries	qiime
qiime_filter_samples_from_otu_table	qiime
qiime_summarize_taxa_through_plots	qiime
qiime_multiple_split_libraries_fastq	qiime
qiime_beta_diversity_through_plots	qiime
qiime_validate_mapping_file	qiime
mothur_screen_seqs	mothur
mothur_make_contigs	mothur
mothur_get_label	mothur
mothur_chimera_vsearch	mothur
mothur_chimera_pintail	mothur
mothur_split_abund	mothur
mothur_mimarks_attributes	mothur
mothur_summary_single	mothur
mothur_chop_seqs	mothur
mothur_remove_otulabels	mothur
mothur_get_sabund	mothur
mothur_make_sra	mothur
mothur_make_group	mothur
mothur_trim_seqs	mothur
mothur_nmds	mothur
mothur_list_otulabels	mothur
mothur_create_database	mothur
mothur_deunique_tree	mothur
mothur_biom_info	mothur
mothur_pairwise_seqs	mothur
mothur_merge_count	mothur
mothur_pcr_seqs	mothur
mothur_taxonomy_to_krona	mothur
mothur_split_groups	mothur
mothur_classify_tree	mothur
mothur_make_fastq	mothur
mothur_pcoa	mothur
mothur_summary_shared	mothur
mothur_sort_seqs	mothur
mothur_remove_dists	mothur
mothur_make_lefse	mothur
mothur_cluster_classic	mothur
mothur_filter_seqs	mothur
mothur_unique_seqs	mothur
mothur_rename_seqs	mothur
mothur_cooccurrence	mothur
mothur_parse_list	mothur
mothur_get_group	mothur
mothur_make_design	mothur
mothur_get_dists	mothur
mothur_get_otulist	mothur
mothur_merge_groups	mothur
mothur_otu_association	mothur
mothur_merge_files	mothur
mothur_filter_shared	mothur
mothur_phylo_diversity	mothur
mothur_sffinfo	mothur
mothur_sub_sample	mothur
mothur_deunique_seqs	mothur
mothur_chimera_perseus	mothur
mothur_amova	mothur
mothur_align_check	mothur
mothur_align_seqs	mothur
mothur_classify_rf	mothur
mothur_dist_seqs	mothur
mothur_pre_cluster	mothur
mothur_libshuff	mothur
mothur_metastats	mothur
mothur_get_rabund	mothur
mothur_get_otus	mothur
mothur_otu_hierarchy	mothur
mothur_trim_flows	mothur
mothur_cluster_fragments	mothur
mothur_rarefaction_shared	mothur
mothur_classify_seqs	mothur
mothur_phylotype	mothur
mothur_unifrac_unweighted	mothur
mothur_tree_shared	mothur
mothur_get_otulabels	mothur
mothur_count_seqs	mothur
mothur_consensus_seqs	mothur
mothur_collect_shared	mothur
mothur_corr_axes	mothur
mothur_summary_seqs	mothur
mothur_anosim	mothur
mothur_remove_seqs	mothur
mothur_get_communitytype	mothur
mothur_cluster_split	mothur
mothur_summary_tax	mothur
mothur_fastq_info	mothur
mothur_unifrac_weighted	mothur
mothur_get_seqs	mothur
mothur_bin_seqs	mothur
mothur_degap_seqs	mothur
mothur_chimera_ccode	mothur
mothur_primer_design	mothur
mothur_seq_error	mothur
mothur_remove_groups	mothur
mothur_mantel	mothur
mothur_lefse	mothur
mothur_heatmap_bin	mothur
mothur_clearcut	mothur
mothur_get_sharedseqs	mothur
mothur_chimera_bellerophon	mothur
mothur_cluster	mothur
mothur_sens_spec	mothur
mothur_make_shared	mothur
mothur_chimera_slayer	mothur
mothur_remove_lineage	mothur
mothur_reverse_seqs	mothur
mothur_dist_shared	mothur
mothur_shhh_flows	mothur
mothur_get_lineage	mothur
mothur_merge_taxsummary	mothur
mothur_hcluster	mothur
mothur_make_lookup	mothur
mothur_remove_rare	mothur
mothur_collect_single	mothur
mothur_rarefaction_single	mothur
mothur_get_groups	mothur
mothur_chimera_check	mothur
mothur_heatmap_sim	mothur
mothur_get_relabund	mothur
mothur_make_biom	mothur
mothur_classify_otu	mothur
mothur_merge_sfffiles	mothur
mothur_summary_qual	mothur
mothur_venn	mothur
mothur_list_seqs	mothur
mothur_homova	mothur
mothur_pca	mothur
mothur_remove_otus	mothur
mothur_parsimony	mothur
mothur_shhh_seqs	mothur
mothur_get_oturep	mothur
mothur_count_groups	mothur
mothur_get_mimarkspackage	mothur
mothur_normalize_shared	mothur
mothur_indicator	mothur
mothur_get_coremicrobiome	mothur
mothur_chimera_uchime	mothur
obi_stat	obitools
obi_sort	obitools
obi_convert	obitools
obi_clean	obitools
obi_uniq	obitools
obi_grep	obitools
obi_annotate	obitools
obi_illumina_pairend	obitools
obi_ngsfilter	obitools
obi_tab	obitools
ivar_trim	ivar
ivar_removereads	ivar
ivar_variants	ivar
ivar_filtervariants	ivar
ivar_consensus	ivar
ivar_getmasked	ivar
cardinal_colocalization	cardinal
eggnog_mapper	eggnog-mapper-v2
proteinortho_summary	proteinortho
OpenPepXL	openms
XFDR	openms
PercolatorAdapter	openms
maxquant_mqpar	maxquant
proteinortho	proteinortho
cardinal_combine	cardinal
cardinal_spectra_plots	cardinal
cardinal_preprocessing	cardinal
cardinal_quality_report	cardinal
cardinal_mz_images	cardinal
cardinal_data_exporter	cardinal
cardinal_segmentations	cardinal
cardinal_filtering	cardinal
msstats	msstats
msstatstmt	msstats
maxquant	maxquant
cardinal_classification	cardinal
metaquantome_viz	metaQuantome
metaquantome_stat	metaQuantome
metaquantome_expand	metaQuantome
encyclopedia_fasta_to_prosit_csv	encylopeDIA
encyclopedia_quantify	encylopeDIA
encyclopedia_walnut	encylopeDIA
encyclopedia_searchtolib	encylopeDIA
encyclopedia_library_to_blib	encylopeDIA
pepquery	pepQuery
ConsensusID	openms
myrimatch	encyclopeDIA
encyclopedia_encyclopedia	encyclopeDIA
metaquantome_db	metaQuantome
maxquant_mqpar	maxquant
metaquantome_filter	metaQuantome
proteinortho_grab_proteins	proteinortho
cardinal_single_ion_segmentation	cardinal
PSMFeatureExtractor	openms
NovorAdapter	openms
LuciphorAdapter	openms
AssayGeneratorMetabo	openms
SiriusAdapter	openms
MSFraggerAdapter	openms
MSGFPlusAdapter	openms
PeakPickerHiRes	openms
RNAMassCalculator	openms
QualityControl	openms
RNPxlXICFilter	openms
OpenSwathConfidenceScoring	openms
MultiplexResolver	openms
OpenSwathFeatureXMLToTSV	openms
OpenSwathDIAPreScoring	openms
MapStatistics	openms
DigestorMotif	openms
FeatureLinkerLabeled	openms
XTandemAdapter	openms
SpectraFilterWindowMower	openms
OpenSwathWorkflow	openms
QCMerger	openms
IDMapper	openms
IDMassAccuracy	openms
IDRTCalibration	openms
IDSplitter	openms
MRMTransitionGroupPicker	openms
MapAlignerIdentification	openms
IsobaricAnalyzer	openms
ERPairFinder	openms
ClusterMassTraces	openms
ClusterMassTracesByPrecursor	openms
CometAdapter	openms
CompNovo	openms
CompNovoCID	openms
IDMerger	openms
MetaboliteSpectralMatcher	openms
RTEvaluation	openms
QCExporter	openms
SpectraFilterNormalizer	openms
InternalCalibration	openms
MassTraceExtractor	openms
PepNovoAdapter	openms
Digestor	openms
PeptideIndexer	openms
MapRTTransformer	openms
OpenSwathAssayGenerator	openms
DTAExtractor	openms
SequenceCoverageCalculator	openms
MetaProSIP	openms
IDConflictResolver	openms
PeakPickerWavelet	openms
ProteinQuantifier	openms
PeakPickerIterative	openms
Decharger	openms
FuzzyDiff	openms
MzMLSplitter	openms
FileConverter	openms
MassCalculator	openms
SpectraFilterNLargest	openms
MapAlignerPoseClustering	openms
QCEmbedder	openms
Epifany	openms
SpectraFilterThresholdMower	openms
SpectraMerger	openms
OpenSwathDecoyGenerator	openms
PTModel	openms
TargetedFileConverter	openms
TextExporter	openms
TOFCalibration	openms
TransformationEvaluation	openms
XMLValidator	openms
ProteinInference	openms
SvmTheoreticalSpectrumGeneratorTrainer	openms
IDRipper	openms
SpectraSTSearchAdapter	openms
SpectraFilterSqrtMower	openms
SpectraFilterMarkerMower	openms
SpecLibSearcher	openms
MascotAdapterOnline	openms
MapAlignerSpectrum	openms
SpecLibCreator	openms
SemanticValidator	openms
SimpleSearchEngine	openms
LabeledEval	openms
SeedListGenerator	openms
RTModel	openms
MaRaClusterAdapter	openms
RNPxlSearch	openms
PrecursorIonSelector	openms
FeatureFinderCentroided	openms
SpectraFilterParentPeakMower	openms
TICCalculator	openms
MRMMapper	openms
OMSSAAdapter	openms
EICExtractor	openms
MyriMatchAdapter	openms
IDFilter	openms
MSSimulator	openms
BaselineFilter	openms
NucleicAcidSearchEngine	openms
SpectraFilterBernNorm	openms
CVInspector	openms
RNADigestor	openms
DecoyDatabase	openms
ExternalCalibration	openms
FalseDiscoveryRate	openms
FeatureFinderIdentification	openms
FeatureFinderIsotopeWavelet	openms
FeatureFinderMetabo	openms
FeatureFinderMetaboIdent	openms
FeatureFinderMRM	openms
FeatureFinderMultiplex	openms
FeatureLinkerUnlabeled	openms
FeatureLinkerUnlabeledKD	openms
FeatureLinkerUnlabeledQT	openms
FFEval	openms
FidoAdapter	openms
FileFilter	openms
FileInfo	openms
FileMerger	openms
GNPSExport	openms
AccurateMassSearch	openms
DatabaseFilter	openms
DeMeanderize	openms
FeatureFinderSuperHirn	openms
OpenSwathMzMLFileCacher	openms
OpenSwathRewriteToFeatureXML	openms
IDPosteriorErrorProbability	openms
IDFileConverter	openms
IDScoreSwitcher	openms
MapAlignerTreeGuided	openms
MapNormalizer	openms
MascotAdapter	openms
MetaboliteAdductDecharger	openms
MRMPairFinder	openms
MSstatsConverter	openms
MzTabExporter	openms
NoiseFilterGaussian	openms
NoiseFilterSGolay	openms
OpenPepXLLF	openms
OpenSwathChromatogramExtractor	openms
OpenSwathAnalyzer	openms
OpenSwathFileSplitter	openms
OpenSwathRTNormalizer	openms
PhosphoScoring	openms
HighResPrecursorMassCorrector	openms
PrecursorMassCorrector	openms
QCCalculator	openms
CruxAdapter	openms
ConsensusMapNormalizer	openms
QCImporter	openms
SpectraFilterScaler	openms
QCShrinker	openms
QCExtractor	openms
ProteinResolver	openms
IDExtractor	openms
LowMemPeakPickerHiRes	openms
LowMemPeakPickerHiResRandomAccess	openms
proteomics_moff	moff
unipept	unipept
maldi_quant_peak_detection	maldi_quant
diapysef	diapasef
flashlfq	flashlfq
reactome_pathwaymatcher	PathwayMatcher
rawtools	rawtools
dia_umpire_se	DIA-Umpire
custom_pro_db	customprodb
maldi_quant_preprocessing	maldi_quant
megahit_contig2fastg	megahit
percolator_input_converters	percolator
percolator	percolator
pout2mzid	percolator
batched_set_list_creator	percolator
msgfplus	msgfplus
RTPredict	openms
PTPredict	openms
InspectAdapter	openms
InclusionExclusionListCreator	openms
LowMemPeakPickerHiRes_RandomAccess	openms
IDDecoyProbability	openms
RNPxl	openms
AdditiveSeries	openms
TopPerc	openms
RTPredict	openms
PTPredict	openms
morpheus	morpheus
metams_runGC	metams
InspectAdapter	openms
abims_xcms_refine	xcms
InclusionExclusionListCreator	openms
LowMemPeakPickerHiRes_RandomAccess	openms
IDDecoyProbability	openms
RNPxl	openms
metfrag_vis	metfrag
w4mcorcov	ropls
AdditiveSeries	openms
TopPerc	openms
morpheus	morpheus
sirius_csifingerid	sirius
metfrag	metfrag
mspurity_spectralmatching	mspurity
mspurity_purityx	mspurity
mspurity_dimspredictpuritysingle	mspurity
metams_runGC	metams
mspurity_createmsp	mspurity
mspurity_createdatabase	mspurity
mspurity_averagefragspectra	mspurity
mspurity_filterfragspectra	mspurity
mspurity_frag4feature	mspurity
mspurity_puritya	mspurity
mspurity_flagremove	mspurity
isoplot	xcms
abims_xcms_refine	xcms
NmrAnnotation	asics
w4mclassfilter	workflow4metabolomics
asca	metstat
wsdl_hmdb	hmdb
golm_ws_lib_search	gmd
abims_xcms_summary	xcms
abims_CAMERA_annotateDiffreport	camera
abims_xcms_fillPeaks	xcms
abims_xcms_retcor	xcms
abims_xcms_group	xcms
xcms_merge	xcms
xcms_plot_chromatogram	xcms
abims_xcms_xcmsSet	xcms
msnbase_readmsdata	msnbase
sirius_csifingerid	sirius
metfrag	metfrag
mspurity_spectralmatching	mspurity
mspurity_purityx	mspurity
mixomics_multilevel	mixomics
mspurity_dimspredictpuritysingle	mspurity
dimspy_merge_peaklists	mspurity
mspurity_createmsp	mspurity
massbank_ws_searchspectrum	massbank
Probmetab	probmetab
abims_CAMERA_combinexsAnnos	camera
profia	profia
mspurity_createdatabase	mspurity
mspurity_averagefragspectra	mspurity
NmrAlignment	speaq
gmx_energy	gromacs
gmx_get_builtin_file	gromacs
gmx_rg	gromacs
gmx_makendx	gromacs
gmx_restraints	gromacs
gmx_trj	gromacs
gmx_sim	gromacs
gmx_solvate	gromacs
gmx_em	gromacs
gmx_setup	gromacs
gromacs_extract_topology	gromacs
tleap	ambertools
rdconf	RDKit
mspurity_filterfragspectra	mspurity
docking	autodock
ctb_rdkit_descriptors	RDKit
acpype_Amber2Gromacs	gromacs
parmconv	ambertools
ambertools_acpype	ambertools
gmx_merge_topology_files	gromacs
mspurity_frag4feature	mspurity
mspurity_puritya	mspurity
mspurity_flagremove	mspurity
genform	workflow4metabolomics
NmrAnnotation	workflow4metabolomics
xcms_export_samplemetadata	xcms
tablemerge	workflow4metabolomics
intens_check	workflow4metabolomics
idchoice	workflow4metabolomics
normalization	workflow4metabolomics
mixmodel	workflow4metabolomics
asca	workflow4metabolomics
corrtable	workflow4metabolomics
wsdl_hmdb	workflow4metabolomics
bank_inhouse	workflow4metabolomics
lcmsmatching	workflow4metabolomics
golm_ws_lib_search	workflow4metabolomics
NMR_Preprocessing	workflow4metabolomics
NMR_Read	workflow4metabolomics
abims_xcms_summary	workflow4metabolomics
abims_CAMERA_annotateDiffreport	workflow4metabolomics
abims_xcms_fillPeaks	xcms
abims_xcms_retcor	xcms
abims_xcms_group	xcms
xcms_merge	xcms
xcms_plot_chromatogram	xcms
abims_xcms_xcmsSet	xcms
msnbase_readmsdata	workflow4metabolomics
lipidmaps	workflow4metabolomics
w4mjoinpn	workflow4metabolomics
generic_filter	workflow4metabolomics
quality_metrics	workflow4metabolomics
mixomics_multilevel	workflow4metabolomics
checkFormat	workflow4metabolomics
Determine_BC	workflow4metabolomics
Batch_correction	workflow4metabolomics
massbank_ws_searchspectrum	workflow4metabolomics
Probmetab	workflow4metabolomics
abims_CAMERA_combinexsAnnos	workflow4metabolomics
profia	workflow4metabolomics
NmrBucketing	workflow4metabolomics
NmrNormalization	workflow4metabolomics
NmrAlignment	workflow4metabolomics
gmx_energy	gromacs
gmx_get_builtin_file	gromacs
gmx_rg	gromacs
gmx_makendx	gromacs
gmx_restraints	gromacs
gmx_trj	gromacs
gmx_sim	gromacs
gmx_solvate	gromacs
gmx_em	gromacs
gmx_setup	gromacs
gromacs_extract_topology	gromacs
tleap	ambertools
rdconf	RDKit
docking	autodock_vina
ctb_rdkit_descriptors	RDKit
acpype_Amber2Gromacs	ambertools
parmconv	ambertools
ambertools_acpype	ambertools
gmx_merge_topology_files	gromacs
ambertools_parmchk2	ambertools
ambertools_antechamber	ambertools
mmpbsa_mmgbsa	ambertools
dpocket	fpocket
OpenPepXL	openms
fpocket	fpocket
prepare_box	autodock_vina
gmx_md	gromacs
sucos_docking_scoring	SuCOS
chembl	chembl
chembl_structure_pipeline	chembl
gmx_editconf	gromacs
openbabel_subsearch	open_babel
mdanalysis_extract_rmsd	mdanalysis
openbabel_addh	open_babel
openbabel_remIons	open_babel
chembl_structure_pipeline	chembl
gromacs_modify_topology	gromacs
openbabel_remove_protonation_state	open_babel
mdanalysis_ramachandran_protein	mdanalysis
mdanalysis_endtoend	mdanalysis
mdanalysis_cosine_analysis	mdanalysis
mdanalysis_hbonds	mdanalysis
mdanalysis_ramachandran_plot	mdanalysis
mdanalysis_distance	mdanalysis
mdanalysis_dihedral	mdanalysis
openbabel_change_title	open_babel
mdanalysis_rdf	mdanalysis
openbabel_spectrophore_search	open_babel
mdanalysis_angle	mdanalysis
prepare_receptor	autodock_vina
enumerate_charges	RDKit
sdf_to_tab	RDKit
ctb_mordred_descriptors	mordred
ctb_pubchem_download_as_smiles	pubchem
ctb_pubchem_download_assays	pubchem
prepare_ligand	autodock_vina
openbabel_remDuplicates	open_babel
openbabel_filter	open_babel
openbabel_compound_convert	open_babel
openbabel_svg_depiction	open_babel
openbabel_genProp	open_babel
openbabel_obgrep	open_babel
openbabel_remSmall	open_babel
prepare_ligands_for_docking	open_babel
sucos_clustering	SuCOS
sucos_max_score	SuCOS
openbabel_structure_distance_finder	open_babel
ctb_chemfp_mol2fps	chemfp
ctb_chemfp_nxn_clustering	chemfp
ctb_chemfp_butina_clustering	chemfp
ctb_sdf2fps	chemfp
goseq	goseq
bio3d_pca_visualize	bio3d
bio3d_rmsf	bio3d
bio3d_pca	bio3d
bio3d_rmsd	bio3d
bio3d_dccm	bio3d
packmol	PACKMOL-Memgen
get_pdb	pdb
openbabel_multi_obgrep	open_babel
ctb_remIons	open_babel
ctb_subsearch	open_babel
ctb_multi_obgrep	open_babel
ctb_spectrophore_search	open_babel
ctb_confab	open_babel
ctb_online_data_fetch	chemicaltoolbox
ctb_pubchem_download_assays	chemicaltoolbox
ctb_openmg	chemicaltoolbox
ip_landmark_registration	galaxy_image_analysis
plotly_regression_performance_plots	scikit-learn
plotly_ml_performance_plots	scikit-learn
nn_classifier	scikit-learn
svm_classifier	scikit-learn
abims_anova	workflow4metabolomics
Multivariate	workflow4metabolomics
Univariate	workflow4metabolomics
iwtomics_plotwithscale	iwtomics
iwtomics_testandplot	iwtomics
iwtomics_loadandplot	iwtomics
biosigner	workflow4metabolomics
Transformation	workflow4metabolomics
Heatmap	workflow4metabolomics
sklearn_to_categorical	scikit-learn
ml_visualization_ex	scikit-learn
sklearn_lightgbm	scikit-learn
sklearn_train_test_split	scikit-learn
sklearn_model_fit	scikit-learn
sklearn_stacking_ensemble_models	scikit-learn
sklearn_estimator_attributes	scikit-learn
model_prediction	scikit-learn
sklearn_train_test_eval	scikit-learn
sklearn_model_validation	scikit-learn
sklearn_discriminant_classifier	scikit-learn
sklearn_regression_metrics	scikit-learn
sklearn_feature_selection	scikit-learn
sklearn_numeric_clustering	scikit-learn
sklearn_nn_classifier	scikit-learn
sklearn_build_pipeline	scikit-learn
sklearn_searchcv	scikit-learn
sklearn_sample_generator	scikit-learn
sklearn_svm_classifier	scikit-learn
sklearn_pairwise_metrics	scikit-learn
sklearn_ensemble	scikit-learn
sklearn_data_preprocess	scikit-learn
sklearn_clf_metrics	scikit-learn
sklearn_generalized_linear	scikit-learn
sklearn_fitted_model_eval	scikit-learn
sklearn_pca	scikit-learn
keras_train_and_eval	scikit-learn
keras_batch_models	scikit-learn
keras_model_builder	scikit-learn
keras_model_config	scikit-learn
ggplot2_heatmap2	ggplot2
pygenomeTracks	pygenometracks
circos_aln_to_links	circos
circos_binlinks	circos
circos_bundlelinks	circos
circos_gc_skew	circos
circos_resample	circos
circos_wiggle_to_scatter	circos
circos_wiggle_to_stacked	circos
circos_tableviewer	circos
circos_interval_to_text	circos
circos_interval_to_tile	circos
intervene_pairwise	intervene
intervene_upset	intervene
jbrowse_to_standalone	jbrowse
pe_histogram	seqcode
build_ucsc_custom_track_1	UCSC_Genome_Browser_Utilities
jvarkit_wgscoverageplotter	jvarkit
newick_display	newick_utilities
taxonomy_krona_chart	taxonomy_krona_chart
export2graphlan	graphlan
plotly_regression_performance_plots	scikit-learn
graphlan	graphlan
graphlan_annotate	graphlan
krona-text	krona
mummerplot_wrapper	mummer
codeml	paml
iqtree	iqtree
rapidnj	rapidnj
meme_chip	meme
meme_psp_gen	meme
meme_dreme	meme
chipeakanno_annopeaks	chippeakanno
clusterprofiler_bitr	clusterprofiler
clusterprofiler_go	clusterprofiler
fasttree	fasttree
gd_raxml	raxml
raxml	raxml
fetch_jbrowse	apollo-seq
feat_from_gff3	apollo-seq
export	apollo-seq
iframe	apollo-seq
create_or_update	apollo-seq
delete_organism	apollo-seq
create_account	apollo-seq
list_organism	apollo-seq
delete_features	apollo-seq
ip_projective_transformation	scikit-image
ip_image_registration	scikit-image
ip_overlay_images	scikit-image
ip_landmark_registration_ls	scikit-image
ip_localthreshold	scikit-image
ip_threshold	scikit-image
ip_projective_transformation_points	scikit-image
ip_spot_detection_2d	scikit-image
ip_points_association_nn	scikit-image
ip_curve_fitting	scikit-image
cp_cellprofiler	CellProfiler
cp_common	CellProfiler
cp_color_to_gray	CellProfiler
cp_tile	CellProfiler
cp_track_objects	CellProfiler
ip_landmark_registration	CellProfiler
cp_overlay_outlines	CellProfiler
cp_convert_objects_to_image	CellProfiler
cp_display_data_on_image	CellProfiler
cp_enhance_or_suppress_features	CellProfiler
cp_export_to_spreadsheet	CellProfiler
cp_gray_to_color	CellProfiler
cp_identify_primary_objects	CellProfiler
cp_mask_image	CellProfiler
cp_measure_granularity	CellProfiler
cp_measure_image_area_occupied	CellProfiler
cp_measure_image_intensity	CellProfiler
cp_measure_image_quality	CellProfiler
cp_measure_object_intensity	CellProfiler
cp_measure_object_size_shape	CellProfiler
cp_measure_texture	CellProfiler
cp_relate_objects	CellProfiler
cp_save_images	CellProfiler
cp_image_math	CellProfiler
imagej2_binary_to_edm	imagej
imagej2_skeletonize3d	imagej
imagej2_find_edges	imagej
imagej2_shadows	imagej
imagej2_enhance_contrast	imagej
imagej2_find_maxima	imagej
imagej2_watershed_binary	imagej
imagej2_bunwarpj_raw_transform	imagej
imagej2_math	imagej
imagej2_bunwarpj_elastic_transform	imagej
ip_viz_overlay_moving_and_fixed_image	scikit-image
ip_wsi_extract_top_view	scikit-image
imagej2_bunwarpj_adapt_transform	imagej
imagej2_adjust_threshold_binary	imagej
imagej2_bunwarpj_compose_elastic	imagej
imagej2_sharpen	imagej
imagej2_make_binary	imagej
imagej2_bunwarpj_convert_to_raw	imagej
imagej2_bunwarpj_compare_raw	imagej
imagej2_bunwarpj_compare_elastic	imagej
imagej2_analyze_skeleton	imagej
imagej2_smooth	imagej
imagej2_bunwarpj_align	imagej
imagej2_bunwarpj_compose_raw	imagej
imagej2_noise	imagej
imagej2_create_image	imagej
imagej2_analyze_particles_binary	imagej
imagej2_bunwarpj_compose_raw_elastic	imagej
imagej2_bunwarpj_compare_elastic_raw	imagej
ip_detection_viz	scikit-image
ip_histogram_equalization	scikit-image
ip_colocalization	scikit-image
ip_2d_feature_extraction	scikit-image
ip_permutate_axis	scikit-image
ip_labelimage_to_points	scikit-image
ip_points_to_label	scikit-image
ip_concat_channels	scikit-image
ip_scale_image	scikit-image
ip_merge_neighbours_in_label	scikit-image
ip_binary_to_labelimage	scikit-image
ip_2d_filter_segmentation_by_features	scikit-image
ip_2d_split_binaryimage_by_watershed	scikit-image
ip_anisotropic_diffusion	scikit-image
ip_color_deconvolution	scikit-image
ip_filter_standard	galaxy_image_analysis
ip_points_to_labe	galaxy_image_analysis
imagecoordinates_flipaxis	galaxy_image_analysis
ip_coordinates_of_roi	galaxy_image_analysis
ip_count_objects	galaxy_image_analysis
ip_mahotas_features	galaxy_image_analysis
ip_overlay_segmentation	galaxy_image_analysis
ip_points_to_binaryimage	galaxy_image_analysis
ip_visceral_evaluatesegmentation	galaxy_image_analysis
ip_binaryimage_to_points	galaxy_image_analysis
ip_slice_image	galaxy_image_analysis
ip_split_labelmap	galaxy_image_analysis
onto_tk_get_ancestor_terms	onto-tools
onto_tk_get_relationship_types	onto-tools
onto_tk_obo2rdf	onto-tools
onto_tk_get_parent_terms	onto-tools
onto_tk_get_parent_terms_by_relationship_type	onto-tools
onto_tk_get_terms	onto-tools
onto_tk_obo2owl	onto-tools
onto_tk_get_relationship_id_vs_relationship_namespace	onto-tools
onto_tk_get_term_synonyms	onto-tools
onto_tk_get_descendent_terms	onto-tools
onto_tk_term_id_vs_term_name	onto-tools
onto_tk_get_child_terms	onto-tools
onto_tk_get_subontology_from	onto-tools
onto_tk_get_relationship_id_vs_relationship_def	onto-tools
onto_tk_get_terms_by_relationship_type	onto-tools
onto_tk_get_root_terms	onto-tools
onto_tk_get_relationship_id_vs_relationship_name	onto-tools
ucsc_cell_browser	ucsc_genome_browser
scanpy_find_markers	scanpy
scanpy_scale_data	scanpy
scanpy_run_umap	scanpy
scanpy_run_tsne	scanpy
scanpy_run_pca	scanpy
scanpy_read_10x	scanpy
scanpy_normalise_data	scanpy
scanpy_find_variable_genes	scanpy
scanpy_find_cluster	scanpy
scanpy_filter_genes	scanpy
scanpy_filter_cells	scanpy
scanpy_compute_graph	scanpy
scanpy_parameter_iterator	scanpy
scanpy_plot_trajectory	scanpy
scmap_index_cell	scmap
sam_merge2	picard_tools
sam_pileup	samtools
samtools_flagstat	samtools
samtools_mpileup	samtools
samtools_rmdup	samtools
samtools_slice_bam	samtools
gatk_count_covariates	gatk
spring_model	spring
spring_minz	spring
spring_cross	spring
pubmed_by_queries	pubmed
text_to_wordmatrix	pubmed
abstracts_by_pmids	pubmed
pmids_to_pubtator_matrix	pubmed
spring_model_all	spring
spring_map	spring
spring_mcc	spring
length_and_gc_content	r
malt_run	malt
maaslin2	MaAsLin 2
Kraken2Tax	kraken2tax
instrain_profile	inStrain
humann_strain_profiler	humann3
humann_split_stratified_table	humann3
humann_rename_table	humann3
humann_join_tables	humann3
humann_associate	humann3
humann_regroup_table	humann3
humann	humann3
humann_split_table	humann3
humann_renorm_table	humann3
humann_barplot	humann3
bio_hansel	bio_hansel
staramr_search	staramr
humann_reduce_table	humann3
humann_rna_dna_norm	humann3
humann_unpack_pathways	humann3
# testing tool mapping for test case
cheetah_problem_unbound_var_input	bwa
